11111111111
1         1
1    2    1
1         1
11111111111